1111111111111111
1000000000000001
1010001111011101
1010000000010001
1011101000010001
1000001010000001
1011100010111001
1000000010000001
1111111111111111