20 20
11111111111111111111
13000004400000000031
10000044001100000001
10011000001100011001
10010002200220001001
10000002200220000001
14400000033000000441
14400110011001100441
10000100033000100001
10000000011000000001
10022000011000022001
10022001111110022001
10000001000010000001
14400001033010000441
14400301111110300441
10000000000000000001
10011100044000111001
10011100044000111001
13000000000000000031
11111111111111111111