50 50
00000000001111111111111111111111111110000000000000
00000000001000000000000000000000000010000000000000
00000000001000000000000000000000000010000000000000
00000000001000000000000000000000000010000000000000
00000000111000000000000000000000000010000000000000
00000000100000000000000000000000000010000000000000
11111111100000000000000000000000000010000000000000
10000000000000000000000000000000000010000000000000
10000000000000000000000000000000000010000000000000
10000000000000000000000000000000000010000000000000
11111111100000000000000000000000000010000000000000
00000000111000000000000000000000000010000000000000
00000000011000000000000000000000000010000000000000
00000000001000000000000000000000000010000000000000
00000000001000000000000000000000000010000000000000
00000000001000000000000000000000111110000000000000
00000000001000000000000000000000100000000000000000
00000000001000000000000000000000100000000000000000
00000000001000000000000000000000100000000000000000
00000000001000000000000000000000100000000000000000
00000000001000000000000000000000100000000000000000
00000000001000000000000000000000100000000000000000
00000000001000000000000000000000100000000000000000
00000000001111111111100000000000100000000000000000
00000000000000000000100000000000100000000000000000
00000000000000000000100000000000100000000000000000
00000000000000000000100000000000100000000000000000
00000000000000000000100000000000100000000000000000
00000000000000000000100000000000100000000000000000
00000000000000000000111111100000100000000000000000
00000000000000000000000000100000100000000000000000
00000000000000000000000000100000100000000000000000
00000000000000000000000000100000100000000000000000
00000000000000000000000000100000100000000000000000
00000000000000000000001111100000100000000000000000
00000000000000000000001000000000100000000000000000
00000000000000000000001000000000111111111111111111
00000000000000000000001000000000000000000000000001
00000000000000000000001000000000000000000000000001
00000000000000000000001000000000000000000000000001
00000000000000000000001000000000000000000000000001
00000000000000000000001100000000000000000000000001
00000000000000000000000100000000000000000000000001
00000000000000000000000100000000000000000000000001
00000000000000000000000100000000000000000000000001
00000000000000000000000100000000000000000000000001
00000000000000000000000100000000000000000000000001
00000000000000000000000100000000000000000000000001
00000000000000000000000100000000000000000000000001
00000000000000000000000111111111111111111111111111
