20 20
11111111111111111111
13000003300000000031
10000033001100000001
10011000001100011001
10010002200220001001
10000002200220000001
13300000033000000331
13300110011001100331
10000100033000100001
10000000011000000001
10022000011000022001
10022001111110022001
10000001000010000001
13300001033010000331
13300301111110300331
10000000000000000001
10011100033000111001
10011100033000111001
13000000000000000031
11111111111111111111