54 110
3.0 8.0
000000000011111111111111111111111111100000000000000000
000000000010000000001000000000000000100000000000000000
000000000010000000001000000000000000100000000000000000
000000000010000000001000000000000000100000000000000000
111111111110000000001000000000000000100000000000000000
100000001000000000001000011111110000100000000000000000
100000001000000000001000010000000000100000000000000000
100000000000000000001111110000000000100000000000000000
100000000000000000000000000000000000100000000000000000
100000001000000000000000000000000000100000000000000000
100000001000000000000000000000000000100000000000000000
111111111110000000000000000000000000100000000000000000
000000000010000000000000000000000000100000000000000000
000000000010000000000111111000000000100000000000000000
000000000010000000000100001000000000100000000000000000
000000000010000000000100001000001111100000000000000000
000000000010000000000100001000001000100000000000000000
000000000010000000000100001000001000100000000000000000
000000000010000000000111111000001000100000000000000000
000000000010000000000000000000001000100000000000000000
000000000010000000000000000000001000100000000000000000
000000000010000000000000000000001000100000000000000000
000000000010000000000000000000001000100000000000000000
000000000011111111111000000000001000100000000000000000
000000000000000000001000000000001000100000000000000000
000000000000000000001000000000001000100000000000000000
000000000000000000001000000000001000100000000000000000
000011111111111111111000000000001000100000000000000000
000010000000000000001000000000001000100000000000000000
000010000000000000001111111000001000100000000000000000
000010000000000000001000001000001000100000000000000000
000010000000000000001000001000001000100000000000000000
000010000000000000001000001000001000100000000000000000
000010000000000000001000001000001000100000000000000000
000010000000000000001111111000001000100000000000000000
000010000000000000000000000000001000100000000000000000
000010000000000000000000000000001111111111111111111111
000011100000000000000000000000000000000000000000000001
000010100000000000000000000000000000000000000000000001
000010111000000000000000000000000000000000000000000001
000010001000000000000000000000000000111111000000000001
000011111111111111111111000000000000100001000000000001
000000000100000000000001111111100000100001000000000001
000000000100000000000001000000100000100001000000000001
000000000100000000000001000000100000100001000000000001
000000000100000000000001000000100000111111000000000001
000000000100000000000001000000100000000000000000000001
000000000100000000000001000000100000000000000000000001
000000000111111111111111000000100111111100000000111001
000000000000000000000001100000100100000100111111111111
000000000000000000000001010000100100000100100000000001
000000000000000000000001001100100100000100100000000001
000000000000000000000001000010100100000100100000000001
111111111111111111111111000001100100000100100000000001
100000000000000000000001100000100100000100100000000001
100000000000000000000001010000000100000100100000000001
100000000000000000000001001100000100000100100000000001
100000000000000000000001000010000100000100100000000001
100000000000000000000001000100000100000100100000000001
100000000000000000000001001000000100000100111111111111
100000000000000000000001010001100100000100000000001001
100001111111111100000001100000100100000100000000001001
100001000000000100000000000000100100000100000000001001
100001000000000100000000000000100100000100000000001001
100001000000000100000000000000100100000100000000001001
100001000000000100000000000000100100000100000000001001
100001111111111100000001100000100100000100000000001001
100000000000000000000001010001100100000100111100111111
100000000000000000000001001000000100000100100000000001
100000000000000000000001000100000100000100100000000001
100000000000000000000001000010000100000100100000000001
100000000000000000000001001100000100000100100000000001
100000000000000000000001010000000100000100111111111111
111111111111111111111111100000100100000100000000000001
000000000000000000000001000001000100000100000000000001
000000000000000000000001000010001100000100000000000001
000000000000000000000001001100010000000100000000000001
000000000000000000000001010000100000000100000000000001
000000000000000000000001100001000000000100000000000001
000000000000000000000010000010000000000100000000000001
000000000000000000001100000100000000000100000000000001
000000001111111111110000001000000000000100000000000001
111111111000000000000000010000000000000111111111111001
100000001000000000000000100000000000000000000000001001
000000000001111111111111000000000000000000000000001001
000000000001000000000000000000000000000000000000001001
000000000001111111111111111111111111111111111111111001
000000001000000000000000000000000000000000000000000001
100000001000000000000000000000000000000000000000000001
111111111000000000000000000000000000000000000000000001
000000001111111111111111111111111111111111111111111111
000000000000000000000000000000000000000000000000000000
000000000000000000000000000000000000000000000000000000
000000000000000000000000000000000000000000000000000000
000000000000000000000000000000000000000000000000000000
000000000000000000000000000000000000000000000000000000
000000000000000000000000000000000000000000000000000000
000000000000000000000000000000000000000000000000000000
000000000000000000000000000000000000000000000000000000
000000000000000000000000000000000000000000000000000000
000000000000000000000000000000000000000000000000000000
000000000000000000000000000000000000000000000000000000
000000000000000000000000000000000000000000000000000000
000000000000000000000000000000000000000000000000000000
000000000000000000000000000000000000000000000000000000
000000000000000000000000000000000000000000000000000000
000000000000000000000000000000000000000000000000000000
000000000000000000000000000000000000000000000000000000
000000000000000000000000000000000000000000000000000000
000000000000000000000000000000000000000000000000000000
