54 110
3.0 9.0
NNNNNNNNNN111111111111111111111111111NNNNNNNNNNNNNNNNN
NNNNNNNNNN100000000010000000000000001NNNNNNNNNNNNNNNNN
NNNNNNNNNN100000000010000000000000001NNNNNNNNNNNNNNNNN
NNNNNNNNNN100000000010000000000000001NNNNNNNNNNNNNNNNN
1111111111100000000010000000000000001NNNNNNNNNNNNNNNNN
1000000010000000000010000111111100001NNNNNNNNNNNNNNNNN
1000000010000000000010000100000000001NNNNNNNNNNNNNNNNN
1000000000000000000011111100000000001NNNNNNNNNNNNNNNNN
1000000000000000000000000000000000001NNNNNNNNNNNNNNNNN
1000000010000000000000000000000000001NNNNNNNNNNNNNNNNN
1000000010000000000000000000000000001NNNNNNNNNNNNNNNNN
1111111111100000000000000000000000001NNNNNNNNNNNNNNNNN
NNNNNNNNNN100000000000000000000000001NNNNNNNNNNNNNNNNN
NNNNNNNNNN100000000001111110000000001NNNNNNNNNNNNNNNNN
NNNNNNNNNN100000000001000010000000001NNNNNNNNNNNNNNNNN
NNNNNNNNNN100000000001000010000011111NNNNNNNNNNNNNNNNN
NNNNNNNNNN100000000001000010000010001NNNNNNNNNNNNNNNNN
NNNNNNNNNN100000000001000010000010001NNNNNNNNNNNNNNNNN
NNNNNNNNNN100000000001111110000010001NNNNNNNNNNNNNNNNN
NNNNNNNNNN100000000000000000000010001NNNNNNNNNNNNNNNNN
NNNNNNNNNN100000000000000000000010001NNNNNNNNNNNNNNNNN
NNNNNNNNNN100000000000000000000010001NNNNNNNNNNNNNNNNN
NNNNNNNNNN100000000000000000000010001NNNNNNNNNNNNNNNNN
NNNNNNNNNN111111111110000000000010001NNNNNNNNNNNNNNNNN
NNNNNNNNNNNNNNNNNNNN10000000000010001NNNNNNNNNNNNNNNNN
NNNNNNNNNNNNNNNNNNNN10000000000010001NNNNNNNNNNNNNNNNN
NNNNNNNNNNNNNNNNNNNN10000000000010001NNNNNNNNNNNNNNNNN
NNNN111111111111111110000000000010001NNNNNNNNNNNNNNNNN
NNNN100000000000000010000000000010001NNNNNNNNNNNNNNNNN
NNNN100000000000000011111110000010001NNNNNNNNNNNNNNNNN
NNNN100000000000000010000010000010001NNNNNNNNNNNNNNNNN
NNNN100000000000000010000010000010001NNNNNNNNNNNNNNNNN
NNNN100000000000000010000010000010001NNNNNNNNNNNNNNNNN
NNNN100000000000000010000010000010001NNNNNNNNNNNNNNNNN
NNNN100000000000000011111110000010001NNNNNNNNNNNNNNNNN
NNNN100000000000000000000000000010001NNNNNNNNNNNNNNNNN
NNNN10000000000000000000000000001111111111111111111111
NNNN11100000000000000000000000000000000000000000000001
NNNN10100000000000000000000000000000000000000000000001
NNNN10111000000000000000000000000000000000000000000001
NNNN10001000000000000000000000000000111111000000000001
NNNN11111111111111111111000000000000100001000000000001
NNNNNNNNN100000000000001111111100000100001000000000001
NNNNNNNNN100000000000001000000100000100001000000000001
NNNNNNNNN100000000000001000000100000100001000000000001
NNNNNNNNN100000000000001000000100000111111000000000001
NNNNNNNNN100000000000001000000100000000000000000000001
NNNNNNNNN100000000000001000000100000000000000000000001
NNNNNNNNN111111111111111000000100111111100000000111001
NNNNNNNNNNNNNNNNNNNNNNN1100000100100000100111111111111
NNNNNNNNNNNNNNNNNNNNNNN1010000100100000100100000000001
NNNNNNNNNNNNNNNNNNNNNNN1001100100100000100100000000001
NNNNNNNNNNNNNNNNNNNNNNN1000010100100000100100000000001
111111111111111111111111000001100100000100100000000001
100000000000000000000001100000100100000100100000000001
100000000000000000000001010000000100000100100000000001
100000000000000000000001001100000100000100100000000001
100000000000000000000001000010000100000100100000000001
100000000000000000000001000100000100000100100000000001
100000000000000000000001001000000100000100111111111111
100000000000000000000001010001100100000100000000001001
100001111111111100000001100000100100000100000000001001
100001000000000100000000000000100100000100000000001001
100001000000000100000000000000100100000100000000001001
100001000000000100000000000000100100000100000000001001
100001000000000100000000000000100100000100000000001001
100001111111111100000001100000100100000100000000001001
100000000000000000000001010001100100000100111100111111
100000000000000000000001001000000100000100100000000001
100000000000000000000001000100000100000100100000000001
100000000000000000000001000010000100000100100000000001
100000000000000000000001001100000100000100100000000001
100000000000000000000001010000000100000100111111111111
111111111111111111111111100000100100000100000000000001
NNNNNNNNNNNNNNNNNNNNNNN1000001000100000100000000000001
NNNNNNNNNNNNNNNNNNNNNNN1000010001100000100000000000001
NNNNNNNNNNNNNNNNNNNNNNN1001100010000000100000000000001
NNNNNNNNNNNNNNNNNNNNNNN1010000100000000100000000000001
NNNNNNNNNNNNNNNNNNNNNNN1100001000000000100000000000001
NNNNNNNNNNNNNNNNNNNNNN10000010000000000100000000000001
NNNNNNNNNNNNNNNNNNNN1100000100000000000100000000000001
NNNNNNNN1111111111110000001000000000000100000000000001
111111111000000000000000010000000000000111111111111001
100000001000000000000000100000000000000000000000001001
000000000001111111111111000000000000000000000000001001
000000000001000000000000000000000000000000000000001001
000000000001111111111111111111111111111111111111111001
000000001000000000000000000000000000000000000000000001
100000001000000000000000000000000000000000000000000001
111111111000000000000000000000000000000000000000000001
NNNNNNNN1111111111111111111111111111111111111111111111
NNNNNNNNNNNNNNNNNNNNNNNNNNNNNNNNNNNNNNNNNNNNNNNNNNNNNN
NNNNNNNNNNNNNNNNNNNNNNNNNNNNNNNNNNNNNNNNNNNNNNNNNNNNNN
NNNNNNNNNNNNNNNNNNNNNNNNNNNNNNNNNNNNNNNNNNNNNNNNNNNNNN
NNNNNNNNNNNNNNNNNNNNNNNNNNNNNNNNNNNNNNNNNNNNNNNNNNNNNN
NNNNNNNNNNNNNNNNNNNNNNNNNNNNNNNNNNNNNNNNNNNNNNNNNNNNNN
NNNNNNNNNNNNNNNNNNNNNNNNNNNNNNNNNNNNNNNNNNNNNNNNNNNNNN
000000000000000000000000000000000000000000000000000000
000000000000000000000000000000000000000000000000000000
000000000000000000000000000000000000000000000000000000
000000000000000000000000000000000000000000000000000000
000000000000000000000000000000000000000000000000000000
000000000000000000000000000000000000000000000000000000
000000000000000000000000000000000000000000000000000000
000000000000000000000000000000000000000000000000000000
000000000000000000000000000000000000000000000000000000
000000000000000000000000000000000000000000000000000000
000000000000000000000000000000000000000000000000000000
000000000000000000000000000000000000000000000000000000
000000000000000000000000000000000000000000000000000000
